12 16 145
23 29 29 29 29 29 29 29 29 29 29 29 29 29 29 24 
21 1 1 1 1 19 6 19 1 19 1 19 6 1 1 22 
21 1 1 1 20 1 1 1 20 1 1 1 20 1 1 22 
21 19 1 19 8 1 1 1 7 19 1 19 17 1 1 22 
21 1 1 1 18 1 1 1 20 1 1 1 1 1 1 22 
21 1 1 1 7 19 4 19 1 1 1 12 10 11 1 22 
21 1 1 1 20 1 1 1 1 12 10 14 2 9 1 22 
21 1 1 16 7 16 17 19 6 13 19 19 3 9 1 22 
21 1 16 16 20 16 16 1 20 9 1 1 1 9 1 22 
21 1 16 16 1 19 6 19 1 15 10 10 10 14 1 22 
21 1 1 1 1 1 1 1 1 1 1 1 1 1 1 22 
31 30 30 30 30 30 30 30 30 30 30 30 30 30 30 32