[SCENE_INFO]
# world_id
1

[MAP]
# file_path
Resources\map\world_map.txt


[TILESET]
1	Resources\map\tileset_worldmap.png	255	255	255	8	4

[STATIC_OBJECTS]
# loai	x	y	w	h	ani_set	state	type_obj
# state: cactus = 1, help_tag = 2, guard = 3
# cactus
5	48	48	48	48	24	1	1
5	96	48	48	48	24	1	1
5	144	48	48	48	24	1	1

5	624	48	48	48	24	1	1
5	672	48	48	48	24	1	1


5	48	96	48	48	24	1	1
5	96	96	48	48	24	1	1
5	144	96	48	48	24	1	1

5	240	96	48	48	24	1	1
5	288	96	48	48	24	1	1
5	336	96	48	48	24	1	1

5	432	96	48	48	24	1	1
5	480	96	48	48	24	1	1
5	528	96	48	48	24	1	1

5	624	96	48	48	24	1	1
5	672	96	48	48	24	1	1


5	240	144	48	48	24	1	1
5	288	144	48	48	24	1	1
5	336	144	48	48	24	1	1

5	624	144	48	48	24	1	1
5	672	144	48	48	24	1	1


5	48	192	48	48	24	1	1
5	96	192	48	48	24	1	1
5	144	192	48	48	24	1	1

5	240	192	48	48	24	1	1
5	288	192	48	48	24	1	1
5	336	192	48	48	24	1	1

5	432	192	48	48	24	1	1
5	480	192	48	48	24	1	1
5	528	192	48	48	24	1	1
5	576	192	48	48	24	1	1
5	624	192	48	48	24	1	1
5	672	192	48	48	24	1	1


5	48	240	48	48	24	1	1
5	96	240	48	48	24	1	1
5	144	240	48	48	24	1	1

5	432	240	48	48	24	1	1
5	480	240	48	48	24	1	1

5	672	240	48	48	24	1	1


5	48	288	48	48	24	1	1

5	288	288	48	48	24	1	1
5	336	288	48	48	24	1	1
5	384	288	48	48	24	1	1

5	672	288	48	48	24	1	1

5	672	288	48	48	24	1	1
5	672	336	48	48	24	1	1
5	672	384	48	48	24	1	1

# help tag
5	624	288	48	48	24	2	1

# guard
5	250	432	48	48	24	3	1


[MAP_SELECTION]
# id	x	y	is	l	t	r	b	state
0	96	144	1	-1	-1	2	-1	0
1	192	48	1	-1	-1	7	2	1
2	192	144	0	0	1	-1	-1	8
3	192	240	0	-1	-1	9	4	8
4	192	336	0	-1	3	-1	5	8
5	192	432	1	-1	4	11	-1	5
6	288	336	0	-1	-1	10	-1	8
7	384	48	1	1	-1	12	8	2
8	384	144	0	-1	7	13	9	8
9	384	240	1	3	8	-1	-1	7
10	384	336	0	6	-1	16	11	8
11	384	432	1	5	10	-1	-1	6
12	480	48	1	7	-1	14	-1	3
13	480	144	1	8	-1	15	-1	4
14	576	48	0	12	-1	-1	15	8
15	576	144	0	13	14	-1	-1	8
16	576	336	0	10	-1	-1	-1	8


